,STATE_NAME,Lg_Dist_Code,DISTRICT_NAME,MICRO_x,SMALL_x,MEDIUM_x,Total_x,Last_Updated,MICRO_y,SMALL_y,MEDIUM_y,Total_y
0,ANDHRA PRADESH,502,ANANTHAPUR,11370,483,33,11886,2022-01-11,7797,238,10,8045
1,ANDHRA PRADESH,503,CHITOOR,13037,592,51,13680,2022-01-11,9623,351,19,9993
2,ANDHRA PRADESH,505,EAST GODAVARI,16711,1044,123,17878,2022-01-11,12347,615,49,13011
3,ANDHRA PRADESH,506,GUNTUR,15955,1678,169,17802,2022-01-11,11386,630,53,12069
4,ANDHRA PRADESH,510,KRISHNA,20460,1673,165,22298,2022-01-11,15189,1007,79,16275
5,ANDHRA PRADESH,511,KURNOOL,11229,558,37,11824,2022-01-11,8972,348,16,9336
6,ANDHRA PRADESH,517,PRAKASAM,9079,524,44,9647,2022-01-11,6527,231,7,6765
7,ANDHRA PRADESH,515,SPSR NELLORE,9783,679,52,10514,2022-01-11,7515,351,19,7885
8,ANDHRA PRADESH,519,SRIKAKULAM,4261,231,15,4507,2022-01-11,2989,98,6,3093
9,ANDHRA PRADESH,520,VISAKHAPATNAM,16534,1416,167,18117,2022-01-11,13102,941,78,14121
10,ANDHRA PRADESH,521,VIZIANAGARAM,3909,225,14,4148,2022-01-11,3093,130,3,3226
11,ANDHRA PRADESH,523,WEST GODAVARI,13617,1046,131,14794,2022-01-11,10450,586,68,11104
12,ANDHRA PRADESH,504,Y.S.R,7869,450,29,8348,2022-01-11,6330,273,15,6618
13,ARUNACHAL PRADESH,628,ANJAW,23,0,0,23,2022-01-11,17,0,0,17
14,ARUNACHAL PRADESH,229,CHANGLANG,192,4,0,196,2022-01-11,70,0,0,70
15,ARUNACHAL PRADESH,230,DIBANG VALLEY,7,0,0,7,2022-01-11,5,0,0,5
16,ARUNACHAL PRADESH,231,EAST KAMENG,21,0,0,21,2022-01-11,18,0,0,18
17,ARUNACHAL PRADESH,232,EAST SIANG,120,3,0,123,2022-01-11,65,0,0,65
18,ARUNACHAL PRADESH,718,KAMLE,7,0,0,7,2022-01-11,3,0,0,3
19,ARUNACHAL PRADESH,677,KRA DAADI,8,1,0,9,2022-01-11,7,0,0,7
20,ARUNACHAL PRADESH,233,KURUNG KUMEY,21,1,0,22,2022-01-11,11,1,0,12
21,ARUNACHAL PRADESH,724,LEPARADA,7,0,0,7,2022-01-11,4,0,0,4
22,ARUNACHAL PRADESH,234,LOHIT,152,1,1,154,2022-01-11,81,0,0,81
23,ARUNACHAL PRADESH,666,LONGDING,16,0,0,16,2022-01-11,7,0,0,7
24,ARUNACHAL PRADESH,235,LOWER DIBANG VALLEY,49,2,0,51,2022-01-11,31,0,0,31
25,ARUNACHAL PRADESH,719,LOWER SIANG,21,0,0,21,2022-01-11,13,0,0,13
26,ARUNACHAL PRADESH,236,LOWER SUBANSIRI,355,2,0,357,2022-01-11,141,2,0,143
27,ARUNACHAL PRADESH,678,NAMSAI,36,0,0,36,2022-01-11,17,0,0,17
28,ARUNACHAL PRADESH,723,PAKKE KESSANG,6,0,0,6,2022-01-11,4,0,0,4
29,ARUNACHAL PRADESH,237,PAPUM PARE,741,62,10,813,2022-01-11,483,36,6,525
30,ARUNACHAL PRADESH,725,SHI YOMI,4,0,0,4,2022-01-11,4,0,0,4
31,ARUNACHAL PRADESH,679,SIANG,10,0,0,10,2022-01-11,7,0,0,7
32,ARUNACHAL PRADESH,238,TAWANG,67,4,0,71,2022-01-11,23,2,0,25
33,ARUNACHAL PRADESH,239,TIRAP,46,2,0,48,2022-01-11,30,1,0,31
34,ARUNACHAL PRADESH,240,UPPER SIANG,26,1,0,27,2022-01-11,12,1,0,13
35,ARUNACHAL PRADESH,241,UPPER SUBANSIRI,50,2,0,52,2022-01-11,32,2,0,34
36,ARUNACHAL PRADESH,242,WEST KAMENG,119,10,0,129,2022-01-11,79,5,0,84
37,ARUNACHAL PRADESH,243,WEST SIANG,68,4,0,72,2022-01-11,37,3,0,40
38,ASSAM,616,BAKSA,1240,10,4,1254,2022-01-11,714,6,1,721
39,ASSAM,280,BARPETA,2929,62,4,2995,2022-01-11,1606,47,4,1657
40,ASSAM,705,Biswanath,881,28,0,909,2022-01-11,519,16,0,535
41,ASSAM,281,BONGAIGAON,1232,43,5,1280,2022-01-11,784,32,3,819
42,ASSAM,282,CACHAR,3541,156,9,3706,2022-01-11,2331,105,5,2441
43,ASSAM,708,CHARAIDEO,464,13,0,477,2022-01-11,199,9,0,208
44,ASSAM,612,CHIRANG,768,28,4,800,2022-01-11,496,13,3,512
45,ASSAM,283,DARRANG,4835,54,4,4893,2022-01-11,4249,42,0,4291
46,ASSAM,284,DHEMAJI,2104,29,0,2133,2022-01-11,1343,20,0,1363
47,ASSAM,285,DHUBRI,1989,35,2,2026,2022-01-11,1007,27,1,1035
48,ASSAM,286,DIBRUGARH,3102,235,6,3343,2022-01-11,2107,138,4,2249
49,ASSAM,299,DIMA HASAO,400,1,1,402,2022-01-11,146,0,0,146
50,ASSAM,287,GOALPARA,1493,31,1,1525,2022-01-11,810,23,1,834
51,ASSAM,288,GOLAGHAT,2174,93,2,2269,2022-01-11,1477,43,1,1521
52,ASSAM,289,HAILAKANDI,1097,18,1,1116,2022-01-11,603,12,0,615
53,ASSAM,709,HOJAI,848,24,1,873,2022-01-11,543,21,1,565
54,ASSAM,290,JORHAT,1993,179,15,2187,2022-01-11,1292,115,7,1414
55,ASSAM,291,KAMRUP,4683,176,27,4886,2022-01-11,2278,70,10,2358
56,ASSAM,618,KAMRUP METRO,8665,1351,177,10193,2022-01-11,6455,983,125,7563
57,ASSAM,292,KARBI-ANGELONG,1097,22,1,1120,2022-01-11,641,11,0,652
58,ASSAM,293,KARIMGANJ,1736,52,1,1789,2022-01-11,1138,41,0,1179
59,ASSAM,294,KOKRAJHAR,1111,25,1,1137,2022-01-11,539,18,0,557
60,ASSAM,295,LAKHIMPUR,1906,64,5,1975,2022-01-11,1110,44,3,1157
61,ASSAM,706,MAJULI,259,1,0,260,2022-01-11,142,1,0,143
62,ASSAM,296,MARIGAON,1494,19,1,1514,2022-01-11,887,10,1,898
63,ASSAM,297,NAGAON,3386,109,8,3503,2022-01-11,1826,58,4,1888
64,ASSAM,298,NALBARI,1649,41,1,1691,2022-01-11,921,25,1,947
65,ASSAM,300,SIVASAGAR,1677,101,5,1783,2022-01-11,932,74,5,1011
66,ASSAM,301,SONITPUR,2517,109,12,2638,2022-01-11,1532,62,11,1605
67,ASSAM,707,SOUTH SALMARA MANCACHAR,156,2,0,158,2022-01-11,81,2,0,83
68,ASSAM,302,TINSUKIA,2755,214,9,2978,2022-01-11,1638,106,9,1753
69,ASSAM,617,UDALGURI,1157,20,2,1179,2022-01-11,600,8,0,608
70,ASSAM,710,WEST KARBI ANGLONG,206,0,0,206,2022-01-11,105,0,0,105
71,BIHAR,188,ARARIA,5338,126,7,5471,2022-01-11,3734,102,3,3839
72,BIHAR,611,ARWAL,894,21,0,915,2022-01-11,579,17,0,596
73,BIHAR,189,AURANGABAD,3849,89,4,3942,2022-01-11,2420,55,3,2478
74,BIHAR,190,BANKA,4206,36,1,4243,2022-01-11,2999,24,1,3024
75,BIHAR,191,BEGUSARAI,8035,189,21,8245,2022-01-11,5356,139,12,5507
76,BIHAR,192,BHAGALPUR,9619,192,14,9825,2022-01-11,6246,145,9,6400
77,BIHAR,193,BHOJPUR,4404,83,3,4490,2022-01-11,2880,55,1,2936
78,BIHAR,194,BUXAR,2658,75,5,2738,2022-01-11,1827,49,1,1877
79,BIHAR,195,DARBHANGA,8139,150,9,8298,2022-01-11,5737,125,5,5867
80,BIHAR,196,GAYA,9941,163,15,10119,2022-01-11,6595,119,10,6724
81,BIHAR,197,GOPALGANJ,5176,71,5,5252,2022-01-11,3512,54,1,3567
82,BIHAR,198,JAMUI,3559,65,1,3625,2022-01-11,2563,57,0,2620
83,BIHAR,199,JEHANABAD,1932,26,1,1959,2022-01-11,1301,12,0,1313
84,BIHAR,200,KAIMUR (BHABUA),2268,78,6,2352,2022-01-11,1322,31,1,1354
85,BIHAR,201,KATIHAR,5977,140,5,6122,2022-01-11,4376,122,3,4501
86,BIHAR,202,KHAGARIA,5223,62,13,5298,2022-01-11,2803,41,1,2845
87,BIHAR,203,KISHANGANJ,2809,52,6,2867,2022-01-11,2117,45,4,2166
88,BIHAR,204,LAKHISARAI,2040,35,1,2076,2022-01-11,1314,24,0,1338
89,BIHAR,205,MADHEPURA,3706,47,1,3754,2022-01-11,2513,43,1,2557
90,BIHAR,206,MADHUBANI,9187,97,1,9285,2022-01-11,6316,82,1,6399
91,BIHAR,207,MUNGER,3580,24,0,3604,2022-01-11,2484,20,0,2504
92,BIHAR,208,MUZAFFARPUR,15348,401,29,15778,2022-01-11,10704,312,20,11036
93,BIHAR,209,NALANDA,6410,109,5,6524,2022-01-11,3845,77,2,3924
94,BIHAR,210,NAWADA,4483,64,2,4549,2022-01-11,2863,52,2,2917
95,BIHAR,211,PASHCHIM  CHAMPARAN,6263,148,2,6413,2022-01-11,4291,105,1,4397
96,BIHAR,212,PATNA,34329,1365,172,35866,2022-01-11,24416,970,105,25491
97,BIHAR,213,PURBI  CHAMPARAN,11475,169,11,11655,2022-01-11,7909,126,5,8040
98,BIHAR,214,PURNIA,8613,294,31,8938,2022-01-11,6392,240,27,6659
99,BIHAR,215,ROHTAS,5634,124,5,5763,2022-01-11,3609,86,3,3698
100,BIHAR,216,SAHARSA,3971,68,3,4042,2022-01-11,2670,53,3,2726
101,BIHAR,217,SAMASTIPUR,10219,174,10,10403,2022-01-11,7208,138,5,7351
102,BIHAR,218,SARAN,7265,101,2,7368,2022-01-11,5000,85,2,5087
103,BIHAR,219,SHEIKHPURA,1538,15,1,1554,2022-01-11,1033,14,0,1047
104,BIHAR,220,SHEOHAR,1581,8,0,1589,2022-01-11,1144,8,0,1152
105,BIHAR,221,SITAMARHI,7441,94,5,7540,2022-01-11,4840,72,2,4914
106,BIHAR,222,SIWAN,5950,90,4,6044,2022-01-11,3774,70,3,3847
107,BIHAR,223,SUPAUL,4190,51,4,4245,2022-01-11,2803,37,4,2844
108,BIHAR,224,VAISHALI,10144,130,8,10282,2022-01-11,6340,102,4,6446
109,CHHATTISGARH,646,BALOD,1389,28,6,1423,2022-01-11,1163,19,3,1185
110,CHHATTISGARH,644,BALOD BAZAR,2977,180,3,3160,2022-01-11,2411,48,1,2460
111,CHHATTISGARH,649,BALRAMPUR,832,8,1,841,2022-01-11,691,4,1,696
112,CHHATTISGARH,374,BASTAR,1448,71,5,1524,2022-01-11,1179,39,3,1221
113,CHHATTISGARH,650,BEMETARA,1700,35,1,1736,2022-01-11,1362,18,0,1380
114,CHHATTISGARH,636,BIJAPUR,166,2,0,168,2022-01-11,136,0,0,136
115,CHHATTISGARH,375,BILASPUR,7418,431,43,7892,2022-01-11,5824,280,20,6124
116,CHHATTISGARH,376,DANTEWADA,371,14,0,385,2022-01-11,288,10,0,298
117,CHHATTISGARH,377,DHAMTARI,1751,95,2,1848,2022-01-11,1346,40,0,1386
118,CHHATTISGARH,378,DURG,8825,587,88,9500,2022-01-11,6702,316,32,7050
119,CHHATTISGARH,645,GARIABAND,750,12,2,764,2022-01-11,638,4,0,642
120,CHHATTISGARH,734,Gaurella Pendra Marwahi,230,4,0,234,2022-01-11,190,1,0,191
121,CHHATTISGARH,379,JANJGIR-CHAMPA,3822,124,4,3950,2022-01-11,2823,71,2,2896
122,CHHATTISGARH,380,JASHPUR,807,31,4,842,2022-01-11,658,27,2,687
123,CHHATTISGARH,382,KABIRDHAM,1460,46,3,1509,2022-01-11,1107,34,2,1143
124,CHHATTISGARH,381,KANKER,1393,23,2,1418,2022-01-11,1194,17,2,1213
125,CHHATTISGARH,643,KONDAGAON,661,9,0,670,2022-01-11,551,7,0,558
126,CHHATTISGARH,383,KORBA,4084,218,33,4335,2022-01-11,3427,168,29,3624
127,CHHATTISGARH,384,KOREA,1459,35,0,1494,2022-01-11,1152,28,0,1180
128,CHHATTISGARH,385,MAHASAMUND,2357,90,2,2449,2022-01-11,1846,43,1,1890
129,CHHATTISGARH,647,MUNGELI,1061,22,1,1084,2022-01-11,827,10,0,837
130,CHHATTISGARH,637,NARAYANPUR,130,1,0,131,2022-01-11,105,1,0,106
131,CHHATTISGARH,386,RAIGARH,4129,263,47,4439,2022-01-11,3340,188,16,3544
132,CHHATTISGARH,387,RAIPUR,17314,1907,297,19518,2022-01-11,13764,1127,132,15023
133,CHHATTISGARH,388,RAJNANDAGAON,3797,182,11,3990,2022-01-11,3030,93,3,3126
134,CHHATTISGARH,642,SUKMA,184,6,0,190,2022-01-11,132,4,0,136
135,CHHATTISGARH,648,SURAJPUR,1298,37,1,1336,2022-01-11,1117,32,0,1149
136,CHHATTISGARH,389,SURGUJA,2245,119,10,2374,2022-01-11,1902,97,8,2007
137,GOA,551,NORTH GOA,6596,403,47,7046,2022-01-11,5110,243,25,5378
138,GOA,552,SOUTH GOA,4960,310,44,5314,2022-01-11,3853,185,15,4053
139,GUJARAT,438,AHMADABAD,115527,9204,1179,125910,2022-01-11,67171,3249,426,70846
140,GUJARAT,439,AMRELI,3968,245,36,4249,2022-01-11,2434,92,2,2528
141,GUJARAT,440,ANAND,9833,446,36,10315,2022-01-11,6590,150,9,6749
142,GUJARAT,672,ARVALLI,2342,135,5,2482,2022-01-11,1777,62,1,1840
143,GUJARAT,441,BANAS KANTHA,11424,482,43,11949,2022-01-11,6014,234,19,6267
144,GUJARAT,442,BHARUCH,11424,1102,88,12614,2022-01-11,7851,435,21,8307
145,GUJARAT,443,BHAVNAGAR,13104,837,105,14046,2022-01-11,8376,235,25,8636
146,GUJARAT,676,BOTAD,1624,122,13,1759,2022-01-11,963,32,2,997
147,GUJARAT,668,CHHOTAUDEPUR,1152,35,4,1191,2022-01-11,870,17,1,888
148,GUJARAT,444,DANG,230,6,0,236,2022-01-11,158,5,0,163
149,GUJARAT,674,DEVBHOOMI DWARKA,2147,120,6,2273,2022-01-11,1669,69,3,1741
150,GUJARAT,445,DOHAD,2339,114,12,2465,2022-01-11,1665,52,7,1724
151,GUJARAT,446,GANDHINAGAR,10657,793,90,11540,2022-01-11,7013,233,16,7262
152,GUJARAT,675,GIR SOMNATH,3072,224,3,3299,2022-01-11,2043,94,1,2138
153,GUJARAT,447,JAMNAGAR,12089,928,85,13102,2022-01-11,6723,349,26,7098
154,GUJARAT,448,JUNAGADH,7912,489,37,8438,2022-01-11,5353,175,8,5536
155,GUJARAT,449,KACHCHH,18048,1720,212,19980,2022-01-11,13166,1056,122,14344
156,GUJARAT,450,KHEDA,6163,264,28,6455,2022-01-11,4286,85,3,4374
157,GUJARAT,451,MAHESANA,8699,1062,173,9934,2022-01-11,5850,346,24,6220
158,GUJARAT,669,MAHISAGAR,928,35,0,963,2022-01-11,663,15,0,678
159,GUJARAT,673,MORBI,8468,1609,335,10412,2022-01-11,4795,280,11,5086
160,GUJARAT,452,NARMADA,660,24,0,684,2022-01-11,515,14,0,529
161,GUJARAT,453,NAVSARI,6288,264,21,6573,2022-01-11,3862,106,3,3971
162,GUJARAT,454,PANCH MAHALS,3512,197,23,3732,2022-01-11,2475,68,5,2548
163,GUJARAT,455,PATAN,3493,197,14,3704,2022-01-11,2023,83,2,2108
164,GUJARAT,456,PORBANDAR,3137,188,10,3335,2022-01-11,2289,105,4,2398
165,GUJARAT,457,RAJKOT,50950,3480,362,54792,2022-01-11,24367,890,104,25361
166,GUJARAT,458,SABAR KANTHA,5933,353,45,6331,2022-01-11,4463,120,8,4591
167,GUJARAT,459,SURAT,107168,9305,708,117181,2022-01-11,42869,1752,166,44787
168,GUJARAT,460,SURENDRANAGAR,6082,383,30,6495,2022-01-11,3247,119,6,3372
169,GUJARAT,641,TAPI,1392,74,5,1471,2022-01-11,1031,32,2,1065
170,GUJARAT,461,VADODARA,41576,2438,317,44331,2022-01-11,29776,1103,118,30997
171,GUJARAT,462,VALSAD,15223,1223,143,16589,2022-01-11,10776,410,19,11205
172,HARYANA,58,AMBALA,9608,603,41,10252,2022-01-11,6194,295,14,6503
173,HARYANA,59,BHIWANI,8056,461,36,8553,2022-01-11,5612,186,7,5805
174,HARYANA,701,CHARKI DADRI,661,31,0,692,2022-01-11,469,12,0,481
175,HARYANA,60,FARIDABAD,27517,2512,294,30323,2022-01-11,17005,907,75,17987
176,HARYANA,61,FATEHABAD,5352,261,23,5636,2022-01-11,3955,132,5,4092
177,HARYANA,62,GURUGRAM,29366,3212,476,33054,2022-01-11,21810,1846,252,23908
178,HARYANA,63,HISAR,13521,766,82,14369,2022-01-11,9981,414,29,10424
179,HARYANA,64,JHAJJAR,6169,676,47,6892,2022-01-11,4355,173,6,4534
180,HARYANA,65,JIND,7944,399,20,8363,2022-01-11,5610,228,11,5849
181,HARYANA,66,KAITHAL,7198,370,42,7610,2022-01-11,5295,137,5,5437
182,HARYANA,67,KARNAL,15114,952,126,16192,2022-01-11,10204,360,22,10586
183,HARYANA,68,KURUKSHETRA,8293,408,15,8716,2022-01-11,6138,229,8,6375
184,HARYANA,69,MAHENDRAGARH,4031,165,6,4202,2022-01-11,3101,98,3,3202
185,HARYANA,604,NUH,3364,107,10,3481,2022-01-11,2790,72,4,2866
186,HARYANA,619,PALWAL,4934,252,29,5215,2022-01-11,3853,137,5,3995
187,HARYANA,70,PANCHKULA,6086,498,46,6630,2022-01-11,4432,260,22,4714
188,HARYANA,71,PANIPAT,14905,1560,124,16589,2022-01-11,8150,470,36,8656
189,HARYANA,72,REWARI,6211,391,43,6645,2022-01-11,4813,254,21,5088
190,HARYANA,73,ROHTAK,6777,533,49,7359,2022-01-11,4786,273,20,5079
191,HARYANA,74,SIRSA,8370,401,38,8809,2022-01-11,6113,229,13,6355
192,HARYANA,75,SONIPAT,9984,1042,122,11148,2022-01-11,6604,262,13,6879
193,HARYANA,76,YAMUNANAGAR,9943,787,27,10757,2022-01-11,6686,257,11,6954
194,HIMACHAL PRADESH,15,BILASPUR,1161,31,3,1195,2022-01-11,911,24,2,937
195,HIMACHAL PRADESH,16,CHAMBA,1247,25,0,1272,2022-01-11,1020,16,0,1036
196,HIMACHAL PRADESH,17,HAMIRPUR,1453,34,2,1489,2022-01-11,1023,23,1,1047
197,HIMACHAL PRADESH,18,KANGRA,5056,171,11,5238,2022-01-11,3886,105,2,3993
198,HIMACHAL PRADESH,19,KINNAUR,245,1,0,246,2022-01-11,187,1,0,188
199,HIMACHAL PRADESH,20,KULLU,2144,59,3,2206,2022-01-11,1762,49,1,1812
200,HIMACHAL PRADESH,21,LAHUL AND SPITI,140,0,0,140,2022-01-11,125,0,0,125
201,HIMACHAL PRADESH,22,MANDI,3325,94,3,3422,2022-01-11,2571,67,3,2641
202,HIMACHAL PRADESH,23,SHIMLA,3298,122,8,3428,2022-01-11,2758,92,6,2856
203,HIMACHAL PRADESH,24,SIRMAUR,1916,211,68,2195,2022-01-11,1398,30,2,1430
204,HIMACHAL PRADESH,25,SOLAN,6350,717,134,7201,2022-01-11,4543,176,9,4728
205,HIMACHAL PRADESH,26,UNA,2174,94,6,2274,2022-01-11,1546,30,0,1576
206,JHARKHAND,322,BOKARO ,9529,285,24,9838,2022-01-11,7269,202,14,7485
207,JHARKHAND,323,CHATRA,1788,32,1,1821,2022-01-11,1453,22,1,1476
208,JHARKHAND,324,DEOGHAR,3643,123,12,3778,2022-01-11,2690,90,8,2788
209,JHARKHAND,325,DHANBAD,12008,422,33,12463,2022-01-11,9402,247,22,9671
210,JHARKHAND,326,DUMKA,2140,61,7,2208,2022-01-11,1591,43,5,1639
211,JHARKHAND,327,EAST SINGHBHUM,11922,647,47,12616,2022-01-11,9213,477,34,9724
212,JHARKHAND,328,GARHWA ,1191,33,0,1224,2022-01-11,922,25,0,947
213,JHARKHAND,329,GIRIDIH,6233,83,9,6325,2022-01-11,4967,54,4,5025
214,JHARKHAND,330,GODDA,2130,41,2,2173,2022-01-11,1365,32,2,1399
215,JHARKHAND,331,GUMLA ,1229,33,0,1262,2022-01-11,878,27,0,905
216,JHARKHAND,332,HAZARIBAG ,6810,132,11,6953,2022-01-11,5462,98,8,5568
217,JHARKHAND,333,JAMTARA,1056,14,0,1070,2022-01-11,842,10,0,852
218,JHARKHAND,606,KHUNTI ,587,18,0,605,2022-01-11,427,10,0,437
219,JHARKHAND,334,KODERMA ,2825,56,4,2885,2022-01-11,2195,40,2,2237
220,JHARKHAND,335,LATEHAR,857,18,1,876,2022-01-11,720,15,0,735
221,JHARKHAND,336,LOHARDAGA ,997,22,1,1020,2022-01-11,747,20,0,767
222,JHARKHAND,337,PAKUR ,1398,29,2,1429,2022-01-11,1063,19,0,1082
223,JHARKHAND,338,PALAMU,2090,70,5,2165,2022-01-11,1614,47,3,1664
224,JHARKHAND,607,RAMGARH ,4188,123,11,4322,2022-01-11,3326,90,2,3418
225,JHARKHAND,339,RANCHI ,17700,848,83,18631,2022-01-11,13197,602,53,13852
226,JHARKHAND,340,SAHEBGANJ,1663,50,2,1715,2022-01-11,1219,34,1,1254
227,JHARKHAND,341,SERAIKELA-KHARSAWAN  ,3213,271,44,3528,2022-01-11,2218,95,9,2322
228,JHARKHAND,342,SIMDEGA ,546,5,1,552,2022-01-11,402,4,0,406
229,JHARKHAND,343,WEST SINGHBHUM,1983,76,8,2067,2022-01-11,1571,54,2,1627
230,KARNATAKA,524,BAGALKOT,7987,183,14,8184,2022-01-11,5649,115,4,5768
231,KARNATAKA,528,BALLARI,8571,559,61,9191,2022-01-11,6889,290,27,7206
232,KARNATAKA,527,BELAGAVI,25805,608,45,26458,2022-01-11,16594,307,16,16917
233,KARNATAKA,526,BENGALURU (RURAL),19999,1031,141,21171,2022-01-11,13435,393,35,13863
234,KARNATAKA,525,BENGALURU (URBAN),119374,9574,1282,130230,2022-01-11,79909,5351,703,85963
235,KARNATAKA,529,BIDAR,4633,135,10,4778,2022-01-11,3446,80,2,3528
236,KARNATAKA,531,CHAMARAJNAGAR,2414,62,3,2479,2022-01-11,1813,40,2,1855
237,KARNATAKA,630,CHIKBALLAPUR,3977,152,8,4137,2022-01-11,2876,90,6,2972
238,KARNATAKA,532,CHIKKAMAGALURU,4148,163,9,4320,2022-01-11,3287,101,3,3391
239,KARNATAKA,533,CHITRADURGA,4180,175,11,4366,2022-01-11,3242,93,3,3338
240,KARNATAKA,534,DAKSHIN KANNAD,14965,730,81,15776,2022-01-11,10808,439,34,11281
241,KARNATAKA,535,DAVANGERE,7033,285,14,7332,2022-01-11,5371,168,7,5546
242,KARNATAKA,536,DHARWAD,16215,597,71,16883,2022-01-11,11771,370,29,12170
243,KARNATAKA,537,GADAG,3978,123,2,4103,2022-01-11,3119,77,1,3197
244,KARNATAKA,539,HASSAN,6916,278,8,7202,2022-01-11,5229,192,2,5423
245,KARNATAKA,540,HAVERI,4577,187,9,4773,2022-01-11,3726,119,2,3847
246,KARNATAKA,538,KALABURAGI,6038,322,31,6391,2022-01-11,4708,158,15,4881
247,KARNATAKA,541,KODAGU,2373,90,9,2472,2022-01-11,1911,51,3,1965
248,KARNATAKA,542,KOLAR,5198,256,20,5474,2022-01-11,3987,137,5,4129
249,KARNATAKA,543,KOPPAL,3481,234,17,3732,2022-01-11,2800,116,2,2918
250,KARNATAKA,544,MANDYA,5936,216,5,6157,2022-01-11,4626,111,2,4739
251,KARNATAKA,545,MYSURU,17130,767,70,17967,2022-01-11,12632,467,28,13127
252,KARNATAKA,546,RAICHUR,5382,410,39,5831,2022-01-11,4566,204,5,4775
253,KARNATAKA,631,RAMANAGARA,4557,214,20,4791,2022-01-11,3151,77,5,3233
254,KARNATAKA,547,SHIVAMOGGA,8214,296,21,8531,2022-01-11,6026,198,9,6233
255,KARNATAKA,548,TUMAKURU,9778,423,34,10235,2022-01-11,6760,215,11,6986
256,KARNATAKA,549,UDUPI,7465,433,42,7940,2022-01-11,5131,180,11,5322
257,KARNATAKA,550,UTTAR KANNAD,6977,144,5,7126,2022-01-11,5165,89,3,5257
258,KARNATAKA,738,VIJAYANAGAR,0,0,0,0,2022-01-11,0,0,0,0
259,KARNATAKA,530,VIJAYAPURA,8784,251,19,9054,2022-01-11,6759,179,11,6949
260,KARNATAKA,635,YADGIR,3941,98,5,4044,2022-01-11,3342,61,1,3404
261,KERALA,554,ALAPPUZHA,9447,418,20,9885,2022-01-11,6095,231,7,6333
262,KERALA,555,ERNAKULAM,25652,2569,263,28484,2022-01-11,16436,1449,134,18019
263,KERALA,556,IDUKKI,4022,227,12,4261,2022-01-11,2715,152,6,2873
264,KERALA,557,KANNUR,9267,419,41,9727,2022-01-11,6393,260,27,6680
265,KERALA,558,KASARAGOD,4395,176,14,4585,2022-01-11,2682,116,3,2801
266,KERALA,559,KOLLAM,9432,626,36,10094,2022-01-11,6136,351,11,6498
267,KERALA,560,KOTTAYAM,8825,572,54,9451,2022-01-11,6022,341,25,6388
268,KERALA,561,KOZHIKODE,11933,663,69,12665,2022-01-11,8150,454,35,8639
269,KERALA,562,MALAPPURAM,10341,559,33,10933,2022-01-11,6803,315,24,7142
270,KERALA,563,PALAKKAD,10551,534,56,11141,2022-01-11,6866,269,20,7155
271,KERALA,564,PATHANAMTHIPTA,4877,237,16,5130,2022-01-11,3463,180,9,3652
272,KERALA,565,THIRUVANANTHAPURAM,20632,768,68,21468,2022-01-11,14650,577,48,15275
273,KERALA,566,THRISSUR,15101,947,93,16141,2022-01-11,9443,529,43,10015
274,KERALA,567,WAYANAD,3217,141,10,3368,2022-01-11,2256,81,5,2342
275,MADHYA PRADESH,667,AGAR MALWA,1900,56,2,1958,2022-01-11,1523,34,2,1559
276,MADHYA PRADESH,639,ALIRAJPUR,817,16,0,833,2022-01-11,520,9,0,529
277,MADHYA PRADESH,390,ANUPPUR,1573,20,1,1594,2022-01-11,1225,14,1,1240
278,MADHYA PRADESH,391,ASHOKNAGAR,1685,101,6,1792,2022-01-11,1273,48,4,1325
279,MADHYA PRADESH,392,BALAGHAT,6113,123,9,6245,2022-01-11,4691,64,2,4757
280,MADHYA PRADESH,393,BARWANI,3232,159,16,3407,2022-01-11,2363,79,1,2443
281,MADHYA PRADESH,394,BETUL,5057,102,7,5166,2022-01-11,3954,74,2,4030
282,MADHYA PRADESH,395,BHIND,2754,58,2,2814,2022-01-11,1923,28,1,1952
283,MADHYA PRADESH,396,BHOPAL,19691,1111,117,20919,2022-01-11,14560,682,60,15302
284,MADHYA PRADESH,397,BURHANPUR,2489,127,8,2624,2022-01-11,1556,22,0,1578
285,MADHYA PRADESH,398,CHHATARPUR,3478,118,4,3600,2022-01-11,2517,76,2,2595
286,MADHYA PRADESH,399,CHHINDWARA,7781,246,24,8051,2022-01-11,6237,159,10,6406
287,MADHYA PRADESH,400,DAMOH,2580,63,2,2645,2022-01-11,2004,52,1,2057
288,MADHYA PRADESH,401,DATIA,1334,53,0,1387,2022-01-11,940,30,0,970
289,MADHYA PRADESH,402,DEWAS,6731,246,19,6996,2022-01-11,5217,111,1,5329
290,MADHYA PRADESH,403,DHAR,7160,414,43,7617,2022-01-11,5376,165,5,5546
291,MADHYA PRADESH,404,DINDORI,1250,9,0,1259,2022-01-11,922,7,0,929
292,MADHYA PRADESH,405,EAST NIMAR,3220,168,12,3400,2022-01-11,2476,82,4,2562
293,MADHYA PRADESH,406,GUNA,4666,153,9,4828,2022-01-11,3449,75,5,3529
294,MADHYA PRADESH,407,GWALIOR,14489,716,66,15271,2022-01-11,10190,440,29,10659
295,MADHYA PRADESH,408,HARDA,1788,75,3,1866,2022-01-11,1360,51,1,1412
296,MADHYA PRADESH,409,HOSHANGABAD,3507,156,30,3693,2022-01-11,2574,103,11,2688
297,MADHYA PRADESH,410,INDORE,35040,3156,351,38547,2022-01-11,23051,1470,143,24664
298,MADHYA PRADESH,411,JABALPUR,12694,605,48,13347,2022-01-11,9146,383,32,9561
299,MADHYA PRADESH,412,JHABUA,1915,57,6,1978,2022-01-11,1312,37,1,1350
300,MADHYA PRADESH,413,KATNI,4064,292,34,4390,2022-01-11,3056,122,10,3188
301,MADHYA PRADESH,414,KHARGONE,5689,220,16,5925,2022-01-11,4157,135,2,4294
302,MADHYA PRADESH,415,MANDLA,2341,53,1,2395,2022-01-11,1843,24,0,1867
303,MADHYA PRADESH,416,MANDSAUR,7380,253,14,7647,2022-01-11,5668,131,6,5805
304,MADHYA PRADESH,417,MORENA,3679,153,21,3853,2022-01-11,2611,82,3,2696
305,MADHYA PRADESH,418,NARSINGHPUR,3272,124,11,3407,2022-01-11,2232,78,1,2311
306,MADHYA PRADESH,419,NEEMUCH,4172,183,16,4371,2022-01-11,3220,80,3,3303
307,MADHYA PRADESH,722,NIWARI,201,5,0,206,2022-01-11,138,4,0,142
308,MADHYA PRADESH,420,PANNA,1903,23,0,1926,2022-01-11,1483,17,0,1500
309,MADHYA PRADESH,421,RAISEN,3866,213,23,4102,2022-01-11,3085,106,1,3192
310,MADHYA PRADESH,422,RAJGARH,5980,145,2,6127,2022-01-11,4580,84,0,4664
311,MADHYA PRADESH,423,RATLAM,6013,314,23,6350,2022-01-11,4474,152,2,4628
312,MADHYA PRADESH,424,REWA,7603,159,12,7774,2022-01-11,5773,113,8,5894
313,MADHYA PRADESH,425,SAGAR,6226,162,12,6400,2022-01-11,4438,110,7,4555
314,MADHYA PRADESH,426,SATNA,6608,259,20,6887,2022-01-11,5063,185,12,5260
315,MADHYA PRADESH,427,SEHORE,5736,154,8,5898,2022-01-11,4660,99,3,4762
316,MADHYA PRADESH,428,SEONI,3778,116,6,3900,2022-01-11,2982,80,5,3067
317,MADHYA PRADESH,429,SHAHDOL,2737,87,3,2827,2022-01-11,2076,62,1,2139
318,MADHYA PRADESH,430,SHAJAPUR,4031,143,1,4175,2022-01-11,3311,85,1,3397
319,MADHYA PRADESH,431,SHEOPUR,651,37,0,688,2022-01-11,452,29,0,481
320,MADHYA PRADESH,432,SHIVPURI,2806,147,4,2957,2022-01-11,2109,83,1,2193
321,MADHYA PRADESH,433,SIDHI,1964,33,2,1999,2022-01-11,1521,29,2,1552
322,MADHYA PRADESH,638,SINGRAULI,2880,93,3,2976,2022-01-11,2154,62,3,2219
323,MADHYA PRADESH,434,TIKAMGARH,1826,73,4,1903,2022-01-11,1267,36,0,1303
324,MADHYA PRADESH,435,UJJAIN,10556,422,18,10996,2022-01-11,7736,226,7,7969
325,MADHYA PRADESH,436,UMARIA,746,16,0,762,2022-01-11,598,12,0,610
326,MADHYA PRADESH,437,VIDISHA,4545,203,6,4754,2022-01-11,3474,113,1,3588
327,MAHARASHTRA,466,AHMEDNAGAR,46600,957,59,47616,2022-01-11,34780,513,20,35313
328,MAHARASHTRA,467,AKOLA,12642,437,38,13117,2022-01-11,9412,157,10,9579
329,MAHARASHTRA,468,AMRAVATI,17884,448,37,18369,2022-01-11,13265,218,9,13492
330,MAHARASHTRA,469,AURANGABAD,57460,1365,173,58998,2022-01-11,42870,649,57,43576
331,MAHARASHTRA,470,BEED,15261,272,23,15556,2022-01-11,11839,149,4,11992
332,MAHARASHTRA,471,BHANDARA,7660,112,5,7777,2022-01-11,5757,58,2,5817
333,MAHARASHTRA,472,BULDHANA,16336,325,22,16683,2022-01-11,12664,178,4,12846
334,MAHARASHTRA,473,CHANDRAPUR,11186,358,35,11579,2022-01-11,8434,231,13,8678
335,MAHARASHTRA,474,DHULE,10033,334,30,10397,2022-01-11,7573,149,11,7733
336,MAHARASHTRA,475,GADCHIROLI,4127,84,3,4214,2022-01-11,3200,47,1,3248
337,MAHARASHTRA,476,GONDIA,8120,252,8,8380,2022-01-11,6093,100,5,6198
338,MAHARASHTRA,477,HINGOLI,6104,110,6,6220,2022-01-11,4885,72,3,4960
339,MAHARASHTRA,478,JALGAON,29097,775,79,29951,2022-01-11,21436,391,23,21850
340,MAHARASHTRA,479,JALNA,18022,311,42,18375,2022-01-11,14195,196,15,14406
341,MAHARASHTRA,480,KOLHAPUR,54864,1928,180,56972,2022-01-11,32599,538,57,33194
342,MAHARASHTRA,481,LATUR,15320,432,47,15799,2022-01-11,11678,238,10,11926
343,MAHARASHTRA,482,MUMBAI ,95428,9963,1925,107316,2022-01-11,69126,5366,942,75434
344,MAHARASHTRA,483,MUMBAI SUBURBAN,113416,6324,981,120721,2022-01-11,84810,3535,512,88857
345,MAHARASHTRA,484,NAGPUR,59298,2624,320,62242,2022-01-11,43168,1442,154,44764
346,MAHARASHTRA,485,NAN DED,17534,322,43,17899,2022-01-11,13293,205,15,13513
347,MAHARASHTRA,486,NANDURBAR,4798,118,10,4926,2022-01-11,3595,76,4,3675
348,MAHARASHTRA,487,NASHIK,62495,2170,206,64871,2022-01-11,45613,1044,72,46729
349,MAHARASHTRA,488,OSMANABAD,12685,124,9,12818,2022-01-11,10009,83,1,10093
350,MAHARASHTRA,665,PALGHAR,44201,1328,107,45636,2022-01-11,31054,341,23,31418
351,MAHARASHTRA,489,PARBHANI,12325,166,19,12510,2022-01-11,9521,103,5,9629
352,MAHARASHTRA,490,PUNE,195410,7891,935,204236,2022-01-11,143132,3937,376,147445
353,MAHARASHTRA,491,RAIGAD,46667,1203,116,47986,2022-01-11,38065,792,55,38912
354,MAHARASHTRA,492,RATNAGIRI,16532,173,9,16714,2022-01-11,11900,104,5,12009
355,MAHARASHTRA,493,SANGLI,28341,751,66,29158,2022-01-11,20215,374,18,20607
356,MAHARASHTRA,494,SATARA,31283,537,44,31864,2022-01-11,22910,270,15,23195
357,MAHARASHTRA,495,SINDHUDURG,8421,90,2,8513,2022-01-11,5424,38,1,5463
358,MAHARASHTRA,496,SOLAPUR,43881,771,66,44718,2022-01-11,31790,449,22,32261
359,MAHARASHTRA,497,THANE,151667,6338,645,158650,2022-01-11,115435,2994,312,118741
360,MAHARASHTRA,498,WARDHA,10979,210,45,11234,2022-01-11,8016,85,6,8107
361,MAHARASHTRA,499,WASHIM,6621,135,15,6771,2022-01-11,5210,102,8,5320
362,MAHARASHTRA,500,YAVATMAL,12394,253,27,12674,2022-01-11,9554,143,7,9704
363,MANIPUR,252,BISHNUPUR,1802,12,0,1814,2022-01-11,934,9,0,943
364,MANIPUR,253,CHANDEL,493,0,1,494,2022-01-11,232,0,1,233
365,MANIPUR,254,CHURACHANDPUR,1122,7,0,1129,2022-01-11,506,4,0,510
366,MANIPUR,255,IMPHAL EAST,5587,59,1,5647,2022-01-11,2490,39,1,2530
367,MANIPUR,256,IMPHAL WEST,6724,145,8,6877,2022-01-11,3394,105,7,3506
368,MANIPUR,713,JIRIBAM,23,0,0,23,2022-01-11,17,0,0,17
369,MANIPUR,711,KAKCHING,361,3,0,364,2022-01-11,155,2,0,157
370,MANIPUR,717,KAMJONG,41,0,0,41,2022-01-11,22,0,0,22
371,MANIPUR,712,KANGPOKPI,127,1,0,128,2022-01-11,67,0,0,67
372,MANIPUR,714,NONEY,36,0,0,36,2022-01-11,14,0,0,14
373,MANIPUR,715,PHERZAWL,2,0,0,2,2022-01-11,1,0,0,1
374,MANIPUR,257,SENAPATI,923,8,0,931,2022-01-11,485,5,0,490
375,MANIPUR,258,TAMENGLONG,249,0,0,249,2022-01-11,112,0,0,112
376,MANIPUR,716,TENGNOUPAL,47,0,0,47,2022-01-11,22,0,0,22
377,MANIPUR,259,THOUBAL,2947,12,0,2959,2022-01-11,1359,11,0,1370
378,MANIPUR,260,UKHRUL,592,0,0,592,2022-01-11,241,0,0,241
379,MEGHALAYA,273,EAST GARO HILLS,66,0,0,66,2022-01-11,51,0,0,51
380,MEGHALAYA,657,EAST JAINTIA HILLS,66,7,0,73,2022-01-11,41,3,0,44
381,MEGHALAYA,274,EAST KHASI HILLS,827,92,8,927,2022-01-11,606,74,7,687
382,MEGHALAYA,656,NORTH GARO HILLS,47,0,0,47,2022-01-11,21,0,0,21
383,MEGHALAYA,276,RI BHOI,198,36,10,244,2022-01-11,126,4,2,132
384,MEGHALAYA,277,SOUTH GARO HILLS,22,0,0,22,2022-01-11,14,0,0,14
385,MEGHALAYA,663,SOUTH WEST  GARO HILLS,113,1,0,114,2022-01-11,84,1,0,85
386,MEGHALAYA,658,SOUTH WEST KHASI HILLS,25,0,0,25,2022-01-11,18,0,0,18
387,MEGHALAYA,278,WEST GARO HILLS,306,9,2,317,2022-01-11,217,5,2,224
388,MEGHALAYA,275,WEST JAINTIA HILLS,114,1,0,115,2022-01-11,78,1,0,79
389,MEGHALAYA,279,WEST KHASI HILLS,44,1,1,46,2022-01-11,30,1,0,31
390,MIZORAM,261,AIZAWL,1291,59,8,1358,2022-01-11,913,40,8,961
391,MIZORAM,262,CHAMPHAI,276,4,0,280,2022-01-11,217,3,0,220
392,MIZORAM,726,Hnahthial,12,0,0,12,2022-01-11,10,0,0,10
393,MIZORAM,728,Khawzawl,43,0,0,43,2022-01-11,42,0,0,42
394,MIZORAM,263,KOLASIB,440,1,0,441,2022-01-11,318,1,0,319
395,MIZORAM,264,LAWNGTLAI,112,0,0,112,2022-01-11,80,0,0,80
396,MIZORAM,265,LUNGLEI,308,3,0,311,2022-01-11,198,2,0,200
397,MIZORAM,266,MAMIT,154,0,0,154,2022-01-11,106,0,0,106
398,MIZORAM,267,SAIHA,61,5,0,66,2022-01-11,39,4,0,43
399,MIZORAM,727,Saitual,34,0,0,34,2022-01-11,26,0,0,26
400,MIZORAM,268,SERCHHIP,211,2,0,213,2022-01-11,53,2,0,55
401,NAGALAND,244,DIMAPUR,1273,36,4,1313,2022-01-11,855,18,2,875
402,NAGALAND,614,KIPHRIE,33,1,0,34,2022-01-11,24,0,0,24
403,NAGALAND,245,KOHIMA,512,9,0,521,2022-01-11,402,5,0,407
404,NAGALAND,615,LONGLENG,7,0,0,7,2022-01-11,6,0,0,6
405,NAGALAND,246,MOKOKCHUNG,270,3,0,273,2022-01-11,133,0,0,133
406,NAGALAND,247,MON,168,1,0,169,2022-01-11,96,0,0,96
407,NAGALAND,736,Noklak,0,0,0,0,2022-01-11,0,0,0,0
408,NAGALAND,613,PEREN,74,0,0,74,2022-01-11,57,0,0,57
409,NAGALAND,248,PHEK,105,0,0,105,2022-01-11,50,0,0,50
410,NAGALAND,249,TUENSANG,135,0,0,135,2022-01-11,12,0,0,12
411,NAGALAND,250,WOKHA,162,2,0,164,2022-01-11,76,0,0,76
412,NAGALAND,251,ZUNHEBOTO,136,1,0,137,2022-01-11,46,0,0,46
413,ODISHA,344,ANGUL,3714,223,22,3959,2022-01-11,3096,181,20,3297
414,ODISHA,345,BALANGIR,3032,120,10,3162,2022-01-11,2205,65,5,2275
415,ODISHA,346,BALESHWAR,5278,230,22,5530,2022-01-11,3851,147,9,4007
416,ODISHA,347,BARGARH,3229,147,13,3389,2022-01-11,2184,98,6,2288
417,ODISHA,348,BHADRAK,3045,73,5,3123,2022-01-11,2272,53,2,2327
418,ODISHA,349,BOUDH,790,15,0,805,2022-01-11,590,6,0,596
419,ODISHA,350,CUTTACK,12459,635,61,13155,2022-01-11,9020,438,43,9501
420,ODISHA,351,DEOGARH,527,6,0,533,2022-01-11,353,5,0,358
421,ODISHA,352,DHENKANAL,2828,83,2,2913,2022-01-11,2004,58,1,2063
422,ODISHA,353,GAJAPATI,741,18,1,760,2022-01-11,519,15,1,535
423,ODISHA,354,GANJAM,10044,387,14,10445,2022-01-11,7237,265,8,7510
424,ODISHA,355,JAGATSINGHPUR,4183,136,4,4323,2022-01-11,3430,115,4,3549
425,ODISHA,356,JAJAPUR,5331,209,19,5559,2022-01-11,3978,156,10,4144
426,ODISHA,357,JHARSUGUDA,2435,167,14,2616,2022-01-11,1974,128,7,2109
427,ODISHA,358,KALAHANDI,2294,109,6,2409,2022-01-11,1754,75,5,1834
428,ODISHA,359,KANDHAMAL,1193,12,1,1206,2022-01-11,939,10,0,949
429,ODISHA,360,KENDRAPARA,3601,74,0,3675,2022-01-11,2675,59,0,2734
430,ODISHA,361,KENDUJHAR,5558,232,31,5821,2022-01-11,4849,199,25,5073
431,ODISHA,362,KHORDHA,17226,1191,128,18545,2022-01-11,12815,834,82,13731
432,ODISHA,363,KORAPUT,2271,124,4,2399,2022-01-11,1668,79,3,1750
433,ODISHA,364,MALKANGIRI  ,1080,29,0,1109,2022-01-11,838,23,0,861
434,ODISHA,365,MAYURBHANJ,3341,126,2,3469,2022-01-11,2676,84,0,2760
435,ODISHA,366,NABARANGPUR,1050,56,2,1108,2022-01-11,798,42,0,840
436,ODISHA,367,NAYAGARH,2018,33,1,2052,2022-01-11,1523,22,0,1545
437,ODISHA,368,NUAPADA,989,27,0,1016,2022-01-11,738,20,0,758
438,ODISHA,369,PURI,5805,86,2,5893,2022-01-11,3894,61,1,3956
439,ODISHA,370,RAYAGADA,1861,65,1,1927,2022-01-11,1394,42,1,1437
440,ODISHA,371,SAMBALPUR,3069,221,12,3302,2022-01-11,2388,149,9,2546
441,ODISHA,372,SONEPUR,1468,28,0,1496,2022-01-11,895,14,0,909
442,ODISHA,373,SUNDARGARH,6508,550,86,7144,2022-01-11,4945,355,39,5339
443,PUNJAB,27,AMRITSAR,16416,1011,79,17506,2022-01-11,10907,443,36,11386
444,PUNJAB,605,BARNALA,3796,162,7,3965,2022-01-11,2662,90,2,2754
445,PUNJAB,28,BATHINDA,10430,571,46,11047,2022-01-11,7470,351,22,7843
446,PUNJAB,29,FARIDKOT,4271,137,16,4424,2022-01-11,3151,80,2,3233
447,PUNJAB,30,FATEHGARH SAHIB,4242,552,167,4961,2022-01-11,2915,266,26,3207
448,PUNJAB,651,FAZILKA,5033,209,39,5281,2022-01-11,3991,115,9,4115
449,PUNJAB,31,FIROZEPUR,5124,159,14,5297,2022-01-11,3991,90,3,4084
450,PUNJAB,32,GURDASPUR,5287,197,9,5493,2022-01-11,3845,98,6,3949
451,PUNJAB,33,HOSHIARPUR,8588,239,15,8842,2022-01-11,6574,146,7,6727
452,PUNJAB,34,JALANDHAR,21480,1110,100,22690,2022-01-11,14603,464,45,15112
453,PUNJAB,35,KAPURTHALA,6193,200,18,6411,2022-01-11,4563,99,7,4669
454,PUNJAB,36,LUDHIANA,46252,4800,478,51530,2022-01-11,23565,1241,87,24893
455,PUNJAB,737,MALERKOTLA,69,0,0,69,2022-01-11,46,0,0,46
456,PUNJAB,37,MANSA,4165,128,6,4299,2022-01-11,2769,61,1,2831
457,PUNJAB,38,MOGA,6549,199,17,6765,2022-01-11,4802,119,5,4926
458,PUNJAB,662,PATHANKOT,2795,121,2,2918,2022-01-11,2203,76,1,2280
459,PUNJAB,41,PATIALA,16054,605,72,16731,2022-01-11,11242,320,17,11579
460,PUNJAB,42,RUPNAGAR,3695,115,10,3820,2022-01-11,2703,85,6,2794
461,PUNJAB,43,SANGRUR,10567,482,40,11089,2022-01-11,6649,203,5,6857
462,PUNJAB,608,SAS NAGAR,18779,984,108,19871,2022-01-11,14000,468,46,14514
463,PUNJAB,40,SHAHID BHAGAT SINGH NAGAR,4057,72,3,4132,2022-01-11,3026,54,0,3080
464,PUNJAB,39,SRI MUKTSAR SAHIB,5012,224,18,5254,2022-01-11,3612,116,4,3732
465,PUNJAB,609,TARN TARAN,3280,57,5,3342,2022-01-11,2425,36,0,2461
466,RAJASTHAN,86,AJMER,26441,1033,73,27547,2022-01-11,17165,402,33,17600
467,RAJASTHAN,87,ALWAR,21218,1179,140,22537,2022-01-11,15152,442,22,15616
468,RAJASTHAN,88,BANSWARA,4762,100,3,4865,2022-01-11,3332,61,3,3396
469,RAJASTHAN,89,BARAN,3888,161,13,4062,2022-01-11,2823,105,8,2936
470,RAJASTHAN,90,BARMER,12592,734,41,13367,2022-01-11,8176,233,8,8417
471,RAJASTHAN,91,BHARATPUR,6929,260,29,7218,2022-01-11,4560,127,7,4694
472,RAJASTHAN,92,BHILWARA,21587,991,111,22689,2022-01-11,13893,339,21,14253
473,RAJASTHAN,93,BIKANER,22868,982,63,23913,2022-01-11,15340,463,20,15823
474,RAJASTHAN,94,BUNDI,5480,108,17,5605,2022-01-11,3884,59,3,3946
475,RAJASTHAN,95,CHITTORGARH,11525,385,24,11934,2022-01-11,7951,233,11,8195
476,RAJASTHAN,96,CHURU,12181,172,9,12362,2022-01-11,7941,90,2,8033
477,RAJASTHAN,97,DAUSA,7732,123,6,7861,2022-01-11,5074,66,2,5142
478,RAJASTHAN,98,DHOLPUR,1987,57,6,2050,2022-01-11,1316,35,1,1352
479,RAJASTHAN,99,DUNGARPUR,4638,61,3,4702,2022-01-11,3518,45,2,3565
480,RAJASTHAN,100,GANGANAGAR,17302,654,60,18016,2022-01-11,12894,424,22,13340
481,RAJASTHAN,101,HANUMANGARH,12385,331,37,12753,2022-01-11,8965,180,8,9153
482,RAJASTHAN,102,JAIPUR,119038,5600,602,125240,2022-01-11,71654,2475,254,74383
483,RAJASTHAN,103,JAISALMER,3428,84,1,3513,2022-01-11,2266,56,0,2322
484,RAJASTHAN,104,JALORE,7510,156,6,7672,2022-01-11,4821,83,1,4905
485,RAJASTHAN,105,JHALAWAR,5466,149,7,5622,2022-01-11,4032,99,4,4135
486,RAJASTHAN,106,JHUNJHUNU,12109,204,13,12326,2022-01-11,8526,125,6,8657
487,RAJASTHAN,107,JODHPUR,38208,1850,127,40185,2022-01-11,22369,752,51,23172
488,RAJASTHAN,108,KARAULI,3171,67,3,3241,2022-01-11,2159,48,0,2207
489,RAJASTHAN,109,KOTA,15786,864,73,16723,2022-01-11,11127,509,45,11681
490,RAJASTHAN,110,NAGAUR,19080,486,23,19589,2022-01-11,12832,242,14,13088
491,RAJASTHAN,111,PALI,14261,582,37,14880,2022-01-11,8943,166,6,9115
492,RAJASTHAN,629,PRATAPGARH,3206,57,1,3264,2022-01-11,2420,23,0,2443
493,RAJASTHAN,112,RAJSAMAND,8007,204,5,8216,2022-01-11,4721,83,2,4806
494,RAJASTHAN,113,SAWAI MADHOPUR,4566,109,2,4677,2022-01-11,3355,80,1,3436
495,RAJASTHAN,114,SIKAR,19395,388,16,19799,2022-01-11,13272,220,10,13502
496,RAJASTHAN,115,SIROHI,6623,155,9,6787,2022-01-11,4786,68,4,4858
497,RAJASTHAN,116,TONK,6255,206,11,6472,2022-01-11,4233,112,3,4348
498,RAJASTHAN,117,UDAIPUR,21551,964,101,22616,2022-01-11,14906,507,42,15455
499,SIKKIM,225,EAST DISTRICT,909,46,8,963,2022-01-11,703,33,8,744
500,SIKKIM,226,NORTH DISTRICT,81,1,0,82,2022-01-11,44,1,0,45
501,SIKKIM,227,SOUTH DISTRICT,222,7,0,229,2022-01-11,180,3,0,183
502,SIKKIM,228,WEST DISTRICT,170,2,0,172,2022-01-11,146,2,0,148
503,TAMIL NADU,610,ARIYALUR,4531,78,5,4614,2022-01-11,3132,60,2,3194
504,TAMIL NADU,730,Chengalpattu,7708,195,9,7912,2022-01-11,6047,132,4,6183
505,TAMIL NADU,568,CHENNAI,92516,6985,893,100394,2022-01-11,69731,4276,503,74510
506,TAMIL NADU,569,COIMBATORE,62419,3679,421,66519,2022-01-11,35876,1266,119,37261
507,TAMIL NADU,570,CUDDALORE,14724,352,18,15094,2022-01-11,9962,207,10,10179
508,TAMIL NADU,571,DHARMAPURI,10796,201,5,11002,2022-01-11,7185,130,2,7317
509,TAMIL NADU,572,DINDIGUL,16037,492,44,16573,2022-01-11,10941,251,8,11200
510,TAMIL NADU,573,ERODE,26047,1372,110,27529,2022-01-11,13380,489,24,13893
511,TAMIL NADU,729,Kallakurichi,2398,51,3,2452,2022-01-11,1732,29,1,1762
512,TAMIL NADU,574,KANCHIPURAM,30175,1464,194,31833,2022-01-11,21780,548,44,22372
513,TAMIL NADU,575,KANNIYAKUMARI,19505,450,25,19980,2022-01-11,12296,259,8,12563
514,TAMIL NADU,576,KARUR,8105,445,31,8581,2022-01-11,4535,159,7,4701
515,TAMIL NADU,577,KRISHNAGIRI,15786,831,54,16671,2022-01-11,9433,354,11,9798
516,TAMIL NADU,578,MADURAI,32140,1106,76,33322,2022-01-11,21491,598,41,22130
517,TAMIL NADU,735,Maliyaduthurai,1855,31,0,1886,2022-01-11,1475,21,0,1496
518,TAMIL NADU,579,NAGAPATTINAM,6680,103,4,6787,2022-01-11,4803,74,0,4877
519,TAMIL NADU,580,NAMAKKAL,19852,1036,116,21004,2022-01-11,11489,469,40,11998
520,TAMIL NADU,581,PERAMBALUR,3133,87,4,3224,2022-01-11,2253,49,2,2304
521,TAMIL NADU,582,PUDUKKOTTAI,10224,240,16,10480,2022-01-11,7460,123,3,7586
522,TAMIL NADU,583,RAMANATHAPURAM,6422,128,8,6558,2022-01-11,4958,66,4,5028
523,TAMIL NADU,731,Ranipet,3104,80,2,3186,2022-01-11,1986,43,2,2031
524,TAMIL NADU,584,SALEM,40958,1554,96,42608,2022-01-11,22107,715,36,22858
525,TAMIL NADU,585,SIVAGANGA,8647,162,14,8823,2022-01-11,6567,96,6,6669
526,TAMIL NADU,733,Tenkasi,4032,98,0,4130,2022-01-11,2711,62,0,2773
527,TAMIL NADU,586,THANJAVUR,16245,387,27,16659,2022-01-11,12320,281,15,12616
528,TAMIL NADU,587,THE NILGIRISH,3042,104,5,3151,2022-01-11,2295,35,4,2334
529,TAMIL NADU,588,THENI,9116,276,28,9420,2022-01-11,6413,131,8,6552
530,TAMIL NADU,589,THIRUVALLUR,28114,1391,137,29642,2022-01-11,18941,526,35,19502
531,TAMIL NADU,590,THIRUVARUR,6971,111,7,7089,2022-01-11,5446,86,1,5533
532,TAMIL NADU,591,TIRUCHIRAPPALLI,22945,713,46,23704,2022-01-11,17030,427,26,17483
533,TAMIL NADU,592,TIRUNELVELI,17725,523,29,18277,2022-01-11,12292,269,11,12572
534,TAMIL NADU,732,Tirupattu,1712,46,0,1758,2022-01-11,1032,19,0,1051
535,TAMIL NADU,634,TIRUPPUR,39779,3134,264,43177,2022-01-11,14546,566,18,15130
536,TAMIL NADU,593,TIRUVANNAMALAI,11926,328,11,12265,2022-01-11,8069,138,5,8212
537,TAMIL NADU,594,TUTICORIN,12651,498,44,13193,2022-01-11,9274,247,20,9541
538,TAMIL NADU,595,VELLORE,18446,615,35,19096,2022-01-11,10781,317,12,11110
539,TAMIL NADU,596,VILLUPURAM,13967,398,17,14382,2022-01-11,9932,213,7,10152
540,TAMIL NADU,597,VIRUDHUNAGAR,17714,890,81,18685,2022-01-11,9352,223,11,9586
541,TELANGANA,501,ADILABAD,2624,90,16,2730,2022-01-11,2259,54,4,2317
542,TELANGANA,690,BHADRADRI KOTHAGUDEM,2800,78,4,2882,2022-01-11,2303,46,2,2351
543,TELANGANA,507,HYDERABAD,42200,5066,923,48189,2022-01-11,31524,3159,464,35147
544,TELANGANA,681,Jagitial,2955,74,0,3029,2022-01-11,2374,37,0,2411
545,TELANGANA,689,JANGOAN,1690,37,3,1730,2022-01-11,1370,19,1,1390
546,TELANGANA,687,JAYASHANKAR BHUPALAPALLY,1323,26,2,1351,2022-01-11,1095,16,2,1113
547,TELANGANA,695,JOGULAMBA GADWAL,1321,38,5,1364,2022-01-11,897,24,1,922
548,TELANGANA,685,KAMAREDDY,2633,78,3,2714,2022-01-11,2359,52,0,2411
549,TELANGANA,508,KARIMNAGAR,9401,347,21,9769,2022-01-11,7232,195,10,7437
550,TELANGANA,509,KHAMMAM,5437,265,17,5719,2022-01-11,4374,168,4,4546
551,TELANGANA,699,KOMARAM BHEEM ASIFABAD,726,25,3,754,2022-01-11,581,9,0,590
552,TELANGANA,688,MAHABUBABAD,2390,70,3,2463,2022-01-11,2084,34,1,2119
553,TELANGANA,512,MAHABUBNAGAR,6251,163,16,6430,2022-01-11,5223,89,7,5319
554,TELANGANA,684,MANCHERIAL,2937,78,2,3017,2022-01-11,2494,55,2,2551
555,TELANGANA,513,MEDAK,3328,156,20,3504,2022-01-11,2780,50,2,2832
556,TELANGANA,700,MEDCHAL MALKAJGIRI,23545,2006,183,25734,2022-01-11,13700,714,56,14470
557,TELANGANA,720,Mulugu,488,9,0,497,2022-01-11,376,6,0,382
558,TELANGANA,694,NAGARKURNOOL,2339,44,0,2383,2022-01-11,1986,24,0,2010
559,TELANGANA,514,NALGONDA,10923,220,29,11172,2022-01-11,8626,102,6,8734
560,TELANGANA,721,Narayanpet,495,14,1,510,2022-01-11,385,10,0,395
561,TELANGANA,680,Nirmal,1510,74,5,1589,2022-01-11,1230,33,1,1264
562,TELANGANA,516,NIZAMABAD,8712,259,14,8985,2022-01-11,7418,158,3,7579
563,TELANGANA,682,PEDDAPALLI,3408,111,3,3522,2022-01-11,2726,71,2,2799
564,TELANGANA,683,RAJANNA SIRCILLA,2365,46,1,2412,2022-01-11,1629,17,1,1647
565,TELANGANA,518,RANGA REDDI,24445,1802,251,26498,2022-01-11,18172,989,116,19277
566,TELANGANA,691,SANGAREDDY,5923,337,62,6322,2022-01-11,4259,109,3,4371
567,TELANGANA,692,SIDDIPET,3211,152,10,3373,2022-01-11,2518,56,5,2579
568,TELANGANA,696,SURYAPET,5405,145,8,5558,2022-01-11,4561,92,3,4656
569,TELANGANA,698,VIKARABAD,2329,66,3,2398,2022-01-11,1933,34,0,1967
570,TELANGANA,693,WANAPARTHY,1576,37,0,1613,2022-01-11,1154,22,0,1176
571,TELANGANA,522,WARANGAL RURAL,2997,98,4,3099,2022-01-11,2588,49,1,2638
572,TELANGANA,686,WARANGAL URBAN,7500,433,29,7962,2022-01-11,6051,263,16,6330
573,TELANGANA,697,YADADRI BHUVANAGIRI,3843,96,8,3947,2022-01-11,2551,27,0,2578
574,TRIPURA,269,DHALAI,394,5,1,400,2022-01-11,221,3,1,225
575,TRIPURA,654,GOMATI,707,13,0,720,2022-01-11,344,10,0,354
576,TRIPURA,652,KHOWAI,323,3,0,326,2022-01-11,180,2,0,182
577,TRIPURA,270,NORTH TRIPURA,864,24,1,889,2022-01-11,440,20,0,460
578,TRIPURA,653,SEPAHIJALA,499,12,0,511,2022-01-11,272,5,0,277
579,TRIPURA,271,SOUTH TRIPURA,553,21,1,575,2022-01-11,287,10,0,297
580,TRIPURA,655,UNAKOTI,435,7,0,442,2022-01-11,275,2,0,277
581,TRIPURA,272,WEST TRIPURA,2328,167,14,2509,2022-01-11,1537,111,8,1656
582,UTTAR PRADESH,118,AGRA,24693,1199,111,26003,2022-01-11,14557,589,51,15197
583,UTTAR PRADESH,119,ALIGARH,10340,409,31,10780,2022-01-11,5597,201,13,5811
584,UTTAR PRADESH,121,AMBEDAKAR NAGAR,3276,92,4,3372,2022-01-11,2179,60,3,2242
585,UTTAR PRADESH,640,AMETHI,2952,76,3,3031,2022-01-11,2109,42,0,2151
586,UTTAR PRADESH,154,AMROHA,2725,108,6,2839,2022-01-11,1818,68,2,1888
587,UTTAR PRADESH,122,AURAIYA,1898,51,0,1949,2022-01-11,1316,38,0,1354
588,UTTAR PRADESH,123,AZAMGARH,7253,85,3,7341,2022-01-11,5441,75,3,5519
589,UTTAR PRADESH,124,BAGHPAT,4459,70,2,4531,2022-01-11,2761,27,0,2788
590,UTTAR PRADESH,125,BAHRAICH,2892,175,13,3080,2022-01-11,2169,119,1,2289
591,UTTAR PRADESH,126,BALLIA,4166,92,3,4261,2022-01-11,2878,71,1,2950
592,UTTAR PRADESH,127,BALRAMPUR,1800,48,2,1850,2022-01-11,1378,34,1,1413
593,UTTAR PRADESH,128,BANDA,1847,53,1,1901,2022-01-11,1384,39,1,1424
594,UTTAR PRADESH,129,BARABANKI,4541,187,24,4752,2022-01-11,3282,96,8,3386
595,UTTAR PRADESH,130,BAREILLY,12633,614,60,13307,2022-01-11,8337,347,36,8720
596,UTTAR PRADESH,131,BASTI,3135,89,6,3230,2022-01-11,2356,69,3,2428
597,UTTAR PRADESH,179,BHADOHI,4595,81,4,4680,2022-01-11,2470,34,2,2506
598,UTTAR PRADESH,132,BIJNOR,4212,124,12,4348,2022-01-11,2771,75,8,2854
599,UTTAR PRADESH,133,BUDAUN,3286,94,6,3386,2022-01-11,2302,72,1,2375
600,UTTAR PRADESH,134,BULANDSHAHAR,7291,266,24,7581,2022-01-11,4585,131,6,4722
601,UTTAR PRADESH,135,CHANDAULI,3198,122,13,3333,2022-01-11,2252,60,4,2316
602,UTTAR PRADESH,136,CHITRAKOOT,1462,20,1,1483,2022-01-11,1044,17,0,1061
603,UTTAR PRADESH,137,DEORIA,5577,94,4,5675,2022-01-11,4016,69,2,4087
604,UTTAR PRADESH,138,ETAH,2290,114,6,2410,2022-01-11,1619,84,4,1707
605,UTTAR PRADESH,139,ETAWAH,2759,76,8,2843,2022-01-11,1779,54,5,1838
606,UTTAR PRADESH,140,FAIZABAD,4172,140,11,4323,2022-01-11,3198,105,7,3310
607,UTTAR PRADESH,141,FARRUKHABAD,2629,65,1,2695,2022-01-11,1707,46,1,1754
608,UTTAR PRADESH,142,FATEHPUR,3628,105,2,3735,2022-01-11,2712,80,1,2793
609,UTTAR PRADESH,143,FIROZABAD,5882,188,21,6091,2022-01-11,3302,79,5,3386
610,UTTAR PRADESH,144,GAUTAM BUDDHA NAGAR,29195,2824,411,32430,2022-01-11,19320,1108,124,20552
611,UTTAR PRADESH,145,GHAZIABAD,32611,2250,269,35130,2022-01-11,21095,940,109,22144
612,UTTAR PRADESH,146,GHAZIPUR,7012,68,3,7083,2022-01-11,5090,48,1,5139
613,UTTAR PRADESH,147,GONDA,3752,139,5,3896,2022-01-11,2804,102,4,2910
614,UTTAR PRADESH,148,GORAKHAPUR,10480,520,48,11048,2022-01-11,7403,341,27,7771
615,UTTAR PRADESH,149,HAMIRPUR,1441,51,0,1492,2022-01-11,1132,31,0,1163
616,UTTAR PRADESH,661,HAPUR,5253,304,32,5589,2022-01-11,3025,103,8,3136
617,UTTAR PRADESH,150,HARDOI,5055,153,10,5218,2022-01-11,3734,108,5,3847
618,UTTAR PRADESH,163,HATHRAS,3858,157,11,4026,2022-01-11,2395,63,2,2460
619,UTTAR PRADESH,151,JALAUN,1748,61,4,1813,2022-01-11,1268,43,2,1313
620,UTTAR PRADESH,152,JAUNPUR,8185,112,4,8301,2022-01-11,6205,81,2,6288
621,UTTAR PRADESH,153,JHANSI,6453,318,22,6793,2022-01-11,4675,218,12,4905
622,UTTAR PRADESH,155,KANNAUJ,2270,46,0,2316,2022-01-11,1470,32,0,1502
623,UTTAR PRADESH,156,KANPUR DEHAT,2451,76,10,2537,2022-01-11,1788,34,1,1823
624,UTTAR PRADESH,157,KANPUR NAGAR,22656,1696,200,24552,2022-01-11,13411,818,98,14327
625,UTTAR PRADESH,633,KASGANJ,1438,47,4,1489,2022-01-11,932,29,1,962
626,UTTAR PRADESH,158,KAUSHAMBI,2125,34,0,2159,2022-01-11,1530,28,0,1558
627,UTTAR PRADESH,160,KUSHINAGAR,3836,95,7,3938,2022-01-11,2829,81,5,2915
628,UTTAR PRADESH,159,LAKHIMPUR KHERI,4534,221,8,4763,2022-01-11,3511,148,8,3667
629,UTTAR PRADESH,161,LALITPUR,1550,72,6,1628,2022-01-11,1166,45,4,1215
630,UTTAR PRADESH,162,LUCKNOW,34676,1843,202,36721,2022-01-11,26146,1247,125,27518
631,UTTAR PRADESH,164,MAHARAJGANJ,3147,86,3,3236,2022-01-11,2335,62,2,2399
632,UTTAR PRADESH,165,MAHOBA,1309,59,3,1371,2022-01-11,839,20,1,860
633,UTTAR PRADESH,166,MAINPURI,2547,93,10,2650,2022-01-11,1854,59,3,1916
634,UTTAR PRADESH,167,MATHURA,12776,421,26,13223,2022-01-11,8683,192,10,8885
635,UTTAR PRADESH,168,MAU,3022,40,3,3065,2022-01-11,2263,28,2,2293
636,UTTAR PRADESH,169,MEERUT,18661,849,86,19596,2022-01-11,10753,361,24,11138
637,UTTAR PRADESH,170,MIRZAPUR,4308,127,10,4445,2022-01-11,2810,77,3,2890
638,UTTAR PRADESH,171,MORADABAD,11810,456,25,12291,2022-01-11,5848,223,16,6087
639,UTTAR PRADESH,172,MUZAFFARNAGAR,8536,366,48,8950,2022-01-11,5623,227,16,5866
640,UTTAR PRADESH,173,PILIBHIT,3419,119,6,3544,2022-01-11,2348,57,2,2407
641,UTTAR PRADESH,174,PRATAPGARH,5406,80,2,5488,2022-01-11,3878,66,2,3946
642,UTTAR PRADESH,120,PRAYAGRAJ,14075,513,48,14636,2022-01-11,10580,355,28,10963
643,UTTAR PRADESH,175,RAE BARELI,4609,112,8,4729,2022-01-11,3543,64,5,3612
644,UTTAR PRADESH,176,RAMPUR,4809,219,9,5037,2022-01-11,2958,70,2,3030
645,UTTAR PRADESH,177,SAHARANPUR,11261,300,13,11574,2022-01-11,6779,157,8,6944
646,UTTAR PRADESH,659,SAMBHAL,2705,105,13,2823,2022-01-11,1658,50,2,1710
647,UTTAR PRADESH,178,SANT KABEER NAGAR,2464,47,6,2517,2022-01-11,1656,33,2,1691
648,UTTAR PRADESH,180,SHAHJAHANPUR,3593,227,22,3842,2022-01-11,2625,118,10,2753
649,UTTAR PRADESH,660,SHAMLI,2485,80,4,2569,2022-01-11,1700,45,0,1745
650,UTTAR PRADESH,181,SHRAVASTI,876,20,0,896,2022-01-11,652,12,0,664
651,UTTAR PRADESH,182,SIDDHARTHNAGAR,2113,36,3,2152,2022-01-11,1581,30,2,1613
652,UTTAR PRADESH,183,SITAPUR,4150,158,11,4319,2022-01-11,3078,112,4,3194
653,UTTAR PRADESH,184,SONBHADRA,3393,127,6,3526,2022-01-11,2715,100,5,2820
654,UTTAR PRADESH,185,SULTANPUR,3309,106,1,3416,2022-01-11,2457,86,1,2544
655,UTTAR PRADESH,186,UNNAO,3615,90,10,3715,2022-01-11,2558,60,0,2618
656,UTTAR PRADESH,187,VARANASI,17847,770,98,18715,2022-01-11,12023,474,57,12554
657,UTTARAKHAND,45,ALMORA,2096,17,2,2115,2022-01-11,1690,12,0,1702
658,UTTARAKHAND,46,BAGESHWAR,795,6,1,802,2022-01-11,568,3,1,572
659,UTTARAKHAND,47,CHAMOLI,1298,8,0,1306,2022-01-11,1016,8,0,1024
660,UTTARAKHAND,48,CHAMPAWAT,724,15,1,740,2022-01-11,525,10,1,536
661,UTTARAKHAND,49,DEHRADUN,17741,682,67,18490,2022-01-11,13422,462,39,13923
662,UTTARAKHAND,50,HARIDWAR,9174,657,96,9927,2022-01-11,6181,220,9,6410
663,UTTARAKHAND,51,NAINITAL,5495,290,18,5803,2022-01-11,3988,174,13,4175
664,UTTARAKHAND,52,PAURI GARHWAL,2020,46,6,2072,2022-01-11,1531,29,0,1560
665,UTTARAKHAND,53,PITHORAGARH,1491,22,0,1513,2022-01-11,1010,18,0,1028
666,UTTARAKHAND,54,RUDRA PRAYAG,1034,5,0,1039,2022-01-11,852,4,0,856
667,UTTARAKHAND,55,TEHRI GARHWAL,2166,42,4,2212,2022-01-11,1698,20,3,1721
668,UTTARAKHAND,56,UDHAM SINGH NAGAR,9340,822,88,10250,2022-01-11,6214,273,13,6500
669,UTTARAKHAND,57,UTTARKASHI,1292,6,0,1298,2022-01-11,1027,4,0,1031
670,WEST BENGAL,664,ALIPURDUAR,1652,68,4,1724,2022-01-11,1122,44,3,1169
671,WEST BENGAL,305,BANKURA,3357,163,9,3529,2022-01-11,2447,103,5,2555
672,WEST BENGAL,307,BIRBHUM,4230,212,18,4460,2022-01-11,2732,103,4,2839
673,WEST BENGAL,308,COOCHBEHAR,3390,126,6,3522,2022-01-11,2462,88,2,2552
674,WEST BENGAL,310,DAKSHIN DINAJPUR,2381,71,3,2455,2022-01-11,1496,46,1,1543
675,WEST BENGAL,309,DARJEELING,5688,653,55,6396,2022-01-11,4263,442,34,4739
676,WEST BENGAL,317,EAST MEDINIPUR,8951,475,26,9452,2022-01-11,6654,315,18,6987
677,WEST BENGAL,312,HOOGHLY,9359,542,35,9936,2022-01-11,5744,289,10,6043
678,WEST BENGAL,313,HOWRAH,12464,1162,94,13720,2022-01-11,6443,431,22,6896
679,WEST BENGAL,314,JALPAIGURI,4214,289,21,4524,2022-01-11,2990,135,10,3135
680,WEST BENGAL,703,Jhargram,707,25,0,732,2022-01-11,517,16,0,533
681,WEST BENGAL,702,KALIMPONG,384,13,0,397,2022-01-11,235,10,0,245
682,WEST BENGAL,315,KOLKOTA,28660,6239,1044,35943,2022-01-11,18192,3226,500,21918
683,WEST BENGAL,316,MALDA,4888,205,15,5108,2022-01-11,3605,127,11,3743
684,WEST BENGAL,319,MURSHIDABAD,8360,323,18,8701,2022-01-11,5872,218,10,6100
685,WEST BENGAL,320,NADIA,7051,222,10,7283,2022-01-11,4741,159,9,4909
686,WEST BENGAL,303,NORTH 24 PRAGANAS,21853,1132,109,23094,2022-01-11,14317,679,55,15051
687,WEST BENGAL,704,PASCHIM BARDHAMAN,7439,556,60,8055,2022-01-11,5785,389,28,6202
688,WEST BENGAL,306,PURBA BARDHAMAN,6692,511,22,7225,2022-01-11,4514,226,5,4745
689,WEST BENGAL,321,PURULIA,2224,114,7,2345,2022-01-11,1546,62,3,1611
690,WEST BENGAL,304,SOUTH 24 PRAGANAS,13488,501,41,14030,2022-01-11,8504,256,23,8783
691,WEST BENGAL,311,UTTAR DINAJPUR,3421,232,10,3663,2022-01-11,2537,130,6,2673
692,WEST BENGAL,318,WEST MEDINIPUR,6740,254,24,7018,2022-01-11,5138,163,13,5314
693,ANDAMAN AND NICOBAR ISLANDS,603,NIKOBARS,140,2,0,142,2022-01-11,121,2,0,123
694,ANDAMAN AND NICOBAR ISLANDS,632,NORTH AND MIDDLE ANDAMAN,468,6,0,474,2022-01-11,276,4,0,280
695,ANDAMAN AND NICOBAR ISLANDS,602,SOUTH ANDAMANS,3297,132,7,3436,2022-01-11,2487,105,6,2598
696,CHANDIGARH,44,CHANDIGARH,11435,1007,134,12576,2022-01-11,9010,687,76,9773
697,DADAR AND NAGAR HAVELI,465,DADRA AND NAGAR HAVELLI,3730,419,82,4231,2022-01-11,2511,98,3,2612
698,DAMAN AND DIU,463,DAMAN,1515,284,56,1855,2022-01-11,811,29,2,842
699,DAMAN AND DIU,464,DIU,111,11,0,122,2022-01-11,81,6,0,87
700,DELHI,77,CENTRAL,11185,2270,335,13790,2022-01-11,6410,1221,164,7795
701,DELHI,78,EAST,20484,1933,173,22590,2022-01-11,12953,953,102,14008
702,DELHI,79,NEW DELHI,11834,1550,305,13689,2022-01-11,7872,894,157,8923
703,DELHI,80,NORTH,10398,1891,232,12521,2022-01-11,5813,846,114,6773
704,DELHI,81,NORTH EAST,11134,580,71,11785,2022-01-11,6341,286,46,6673
705,DELHI,82,NORTH WEST,30425,3684,481,34590,2022-01-11,17989,1433,238,19660
706,DELHI,671,SHAHDARA,2698,200,17,2915,2022-01-11,1401,85,8,1494
707,DELHI,83,SOUTH ,21180,2803,448,24431,2022-01-11,15580,1856,265,17701
708,DELHI,670,SOUTH EAST,5171,486,68,5725,2022-01-11,3701,294,34,4029
709,DELHI,84,SOUTH WEST,19009,1813,214,21036,2022-01-11,13882,1150,128,15160
710,DELHI,85,WEST,23243,2190,250,25683,2022-01-11,14657,1062,143,15862
711,JAMMU AND KASHMIR,1,ANANTNAG,9679,128,2,9809,2022-01-11,7281,94,1,7376
712,JAMMU AND KASHMIR,2,BADGAM,7561,64,2,7627,2022-01-11,3273,31,1,3305
713,JAMMU AND KASHMIR,623,BANDIPORA,1780,8,1,1789,2022-01-11,912,6,1,919
714,JAMMU AND KASHMIR,3,BARAMULLA,5934,52,2,5988,2022-01-11,3131,34,2,3167
715,JAMMU AND KASHMIR,4,DODA,1783,12,0,1795,2022-01-11,1393,11,0,1404
716,JAMMU AND KASHMIR,626,GANDERBAL,3431,18,3,3452,2022-01-11,1651,13,2,1666
717,JAMMU AND KASHMIR,5,JAMMU,7690,707,65,8462,2022-01-11,5949,511,31,6491
718,JAMMU AND KASHMIR,7,KATHUA,2963,104,16,3083,2022-01-11,2194,31,1,2226
719,JAMMU AND KASHMIR,620,KISHTWAR,1651,9,0,1660,2022-01-11,1456,9,0,1465
720,JAMMU AND KASHMIR,622,KULGAM,2319,18,1,2338,2022-01-11,1870,13,1,1884
721,JAMMU AND KASHMIR,8,KUPWARA,2331,18,0,2349,2022-01-11,1666,7,0,1673
722,JAMMU AND KASHMIR,10,POONCH,1649,26,2,1677,2022-01-11,1343,18,1,1362
723,JAMMU AND KASHMIR,11,PULWAMA,4863,103,8,4974,2022-01-11,2913,46,7,2966
724,JAMMU AND KASHMIR,12,RAJAURI,2145,38,1,2184,2022-01-11,1832,26,1,1859
725,JAMMU AND KASHMIR,621,RAMBAN,1610,8,1,1619,2022-01-11,1421,8,0,1429
726,JAMMU AND KASHMIR,627,REASI,970,24,0,994,2022-01-11,876,19,0,895
727,JAMMU AND KASHMIR,624,SAMBA,1285,150,24,1459,2022-01-11,741,32,2,775
728,JAMMU AND KASHMIR,625,SHOPIAN,1500,14,4,1518,2022-01-11,1158,9,3,1170
729,JAMMU AND KASHMIR,13,SRINAGAR,10651,306,12,10969,2022-01-11,5097,193,7,5297
730,JAMMU AND KASHMIR,14,UDHAMPUR,1643,47,4,1694,2022-01-11,1277,34,1,1312
731,LADAKH,6,KARGIL,847,14,0,861,2022-01-11,553,9,0,562
732,LADAKH,9,LEH LADAKH,1493,35,0,1528,2022-01-11,1099,23,0,1122
733,LAKSHADWEEP,553,LAKSHADWEEP DISTRICT,150,0,0,150,2022-01-11,114,0,0,114
734,PUDUCHERRY,598,KARAIKAL,1248,56,2,1306,2022-01-11,989,47,1,1037
735,PUDUCHERRY,599,MAHE,95,17,0,112,2022-01-11,71,11,0,82
736,PUDUCHERRY,600,PONDICHERRY,7698,413,50,8161,2022-01-11,5577,202,21,5800
